収支一覧表=statement of account
財務諸表=financial statement
貸借対照表=balance sheet
損益計算書=profit and loss statement
簿記=book keeping
財務会計=financial accounting
管理会計=management  accounting
月次報告=monthly report
流動資産=current assets
現金=cash
銀行預金=cash in bank
受取り手形=notes receivable
棚卸資産=inventory assets
前払い金=advances to suppliers
貸付金=loan receivable
流動負債=current liabilities
支払手形=notes payable
売掛金=account receivable
買掛金=accounts payable
借入金=loan
未収金=account receivable
前受金=advances received
貸倒引当金=allowance for bad debts
貸方=credit 
借方=debit
未払費用=accrued expenses
未払賃金=accrued payroll
未払配当金=dividends payable
監査=audit
総勘定元帳=general ledger
減価償却費=depreciation expense
会計検査=auditing
会計監査=accounting audit
与信=credit lines
連結決算=consolidated settlement of accounts
小口現金=petty cash
創立費=organization expense
