切符売り場=きっぷうりば==售票处
自動券売機=じどうけんばいき==自动售票机
精算機=せいさんき==自动补票机
改札口=かいさつぐち==剪票口
出口=でぐち==出口
入口=いりぐち==入口
東口=ひがしぐち==东出口
西口=にしぐち==西出口
南口=みなみぐち==南出口
北口=きたぐち==北出口
中央口=ちゅうおうぐち==中央出口
=ホーム==月台
売店=ばいてん==贩卖部
=コインロﾂ力ー==投币式寄物箱
=タクシー乗り場==出租车乘车处
=バスターミナル==公交车总站
=バス停==公车站牌
特急=とっきゅう==特快车
急行=きゅうこう==快车
快速=かいそく==平快车
準急=じゅんきゅう==准快车
普通=ふつう==普通车
時刻表=じこくひょう==时刻表
～発=～はつ==～开车
～着=～ちゃく==～抵达
東京行き=とうきょういき==开往东京
定期券=ていきけん==月票
回数券=かいすうけん==回数票
片道=かたみち==单程票
往復=おうふく==来回票
